1200 6 2 3
1201 6 1 3
1202 6 3 3
1203 7 2 3
1204 8 2 3
1205 8 3 3
1206 5 2 3
1207 4 2 3
1208 4 3 3
1209 3 3 3
1210 3 2 3
1211 9 2 3
1212 9 3 3
1213 9 4 3
1214 9 5 3
1215 10 5 3
1216 11 5 3
1217 3 4 3
1218 3 5 3
1219 2 5 3
1220 1 5 3
1221 6 4 3
1222 6 5 3
1223 7 4 3
1224 5 4 3
1225 6 6 3
1226 6 7 3
1227 7 7 3
1228 7 8 3
1229 7 9 3
1230 6 9 3
1231 6 8 3
1232 5 7 3
1233 5 8 3
1234 5 9 3
1235 8 9 3
1236 9 9 3
1237 10 9 3
1238 11 9 3
1239 12 9 3
1240 12 8 3
1241 12 7 3
1242 12 6 3
1243 12 5 3
1244 12 4 3
1245 12 3 3
1246 12 2 3
1247 12 1 3
1248 12 0 3
1249 11 0 3
1250 10 0 3
1251 9 0 3
1252 8 0 3
1253 7 0 3
1254 6 0 3
1255 5 0 3
1256 4 0 3
1257 3 0 3
1258 2 0 3
1259 1 0 3
1260 0 0 3
1261 0 1 3
1262 0 2 3
1263 0 3 3
1264 0 4 3
1265 0 5 3
1266 0 6 3
1267 0 7 3
1268 0 8 3
1269 0 9 3
1270 1 9 3
1271 2 9 3
1272 3 9 3
1273 4 9 3
1274 0 0 0
1275 0 0 0
1276 0 0 0
1277 0 0 0
1278 0 0 0
1279 0 0 0
1280 0 0 0
1281 0 0 0
1282 0 0 0
1283 0 0 0
1284 0 0 0
1285 0 0 0
1286 0 0 0
1287 0 0 0
1288 0 0 0
1289 0 0 0
1290 0 0 0
