* Сгенерировано BZEditor
4000 1 0 0
4001 2 0 0
4002 4 7 0
4003 5 0 0
4004 -1 3 0
4005 6 0 0
4006 7 0 0
4007 4 1 0
4008 4 2 0
4009 4 3 0
4010 4 4 0
4011 3 5 0
4012 4 5 0
4013 4 6 0
4014 3 6 0
4015 5 5 0
4016 5 6 0
4017 6 6 0
4018 7 6 0
4019 8 6 0
4020 3 7 0
4021 3 8 0
4022 3 9 0
4023 2 5 0
4024 1 5 0
4025 0 5 0
4026 -1 5 0
4027 0 4 0
4028 0 3 0
4029 4 10 0
4030 6 7 0
4031 7 5 0
4032 2 8 0
4033 1 8 0
4034 0 8 0
4035 0 7 0
4036 1 9 0
4037 -1 8 0
4038 4 9 0
4039 1 6 0
4040 2 1 0
4041 3 1 0
4042 -1 4 0
4043 1 -1 0
4044 7 1 0
4045 -2 5 0
4046 3 3 0
4047 3 2 0
4048 2 3 0
4049 2 4 0
4050 3 4 0
4051 2 -1 0
4052 -1 2 0
4053 6 -1 0
4054 5 4 0
4055 5 1 0
4056 2 6 0
4057 8 0 0
4058 7 3 0
4060 4 0 0
4061 3 0 0
4062 6 5 0
4063 -1 6 0
4070 1 1 0
4071 7 7 0
